border_size=1
usage=map

Rr          , Gs^Fp       , Gs^Fp       , Gs^Fp       , Gs^Fp       , Gs^Fp       , Gs^Fp       , Gs^Fp       , Mm^Xm       , Mm^Xm       , Mm^Xm       , Mm^Xm       , Mm^Xm       , Mm^Xm       , Mm^Xm       , Mm^Xm       , Mm^Xm       , Mm^Xm       , Mm^Xm       , Mm^Xm       , Mm^Xm       , Gg          , Mm^Xm       , Mm^Xm       , Mm^Xm       , Mm^Xm       , Mm^Xm       , Mm^Xm       , Mm^Xm       , Mm^Xm       , Mm^Xm       , Mm^Xm       , Mm^Xm       , Mm^Xm       , Mm^Xm       , Mm^Xm       , Mm^Xm       , Mm^Xm       , Mm^Xm       , Mm^Xm       , Mm^Xm       , Hh          , Mm^Xm       , Hh          , Mm^Xm       , Mm^Xm       , Mm^Xm       , Mm^Xm       , Mm^Xm       , Ql          , Ql          , Ql          , Re          , Ql          , Ql          , Mm^Xm       , Mm^Xm       , Mm^Xm       , Mm^Xm       , Mm^Xm       , Mm^Xm       , Mm^Xm       
Rr          , Rr          , Rr          , Gs^Fp       , 1 Gs^Fp     , Gs^Fp       , Gs^Fp       , Gs^Fp       , Gg          , Mm^Xm       , Mm^Xm       , Mm^Xm       , Mm          , Mm^Xm       , Mm          , Mm^Xm       , Mm^Xm       , Mm^Xm       , Mm^Xm       , Mm^Xm       , Mm^Xm       , Mm^Xm       , Gs^Fp       , Mm^Xm       , Gs^Fp       , Mm^Xm       , Gg          , Mm^Xm       , Gg          , Gg          , Gs^Fp       , Gs^Fp       , Gs^Fp       , Gs^Fp       , Gg          , Mm^Xm       , Hh          , Mm^Xm       , Hh          , Mm^Xm       , Mm^Xm       , Mm^Xm       , Mm^Xm       , Mm^Xm       , Mm^Xm       , Mm^Xm       , Hh          , Mm^Xm       , Gg          , Ql          , Re          , Ql^Bs/      , Ql          , Ql^Bs\      , Re          , Ql^Bs/      , Re          , Gs^Fp       , Gs^Fp       , Mm^Xm       , Mm^Xm       , Mm^Xm       
Rr          , Rr          , Rr          , Rr          , Rr          , Gs^Fp       , Gs^Fp       , Gs^Fp       , Mm^Xm       , Mm^Xm       , Mm^Xm       , Mm          , Mm          , Mm          , Rr          , Ch          , Ch          , Mm^Xm       , Mm^Xm       , Mm^Xm       , Gs^Fp       , Gs^Fp       , Gs^Fp       , Gs^Fp       , Gs^Fp       , Gs^Fp       , Gg^Fet      , Gg          , Gg          , Gg          , Gs^Fp       , Gs^Fp       , Gg^Ve       , Gs^Fp       , Gg          , Hh          , Hh          , Hh          , Hh          , Hh          , Hh          , Hh^Vhh      , Hh          , Mm^Xm       , Hh          , Hh          , Re          , Gg          , Re          , Re          , Ql^Bs\      , Ql          , Ql^Bs/      , Re          , Ql^Bs\      , Ql          , Re          , Gs^Fp       , Chr         , Chr         , Aa^Fpa      , Mm^Xm       
Gs^Fp       , Rr          , 2 Rr        , Rr          , Rr          , Rr          , Rr          , Rr          , Mm^Xm       , Mm^Xm       , Rr          , Mm          , Rr          , Rr          , Rr          , Rr          , Rr          , Ch          , Gg          , Gs^Fp       , Re          , Gs^Fp       , Re          , Gs^Fp       , Re          , Re          , Re          , Gg          , Gg^Fet      , Gg^Fet      , Gg          , Gs^Fp       , Gs^Fp       , Gs^Fp       , Gg          , Gg          , Gg          , Hh          , Hh          , Hh          , Hh          , Hh          , Re          , Hh          , Re          , Re          , Gg          , Re          , Re          , Gg          , Ql^Bs/      , Re          , Ql^Bs\      , Ql          , Re          , Re          , Re          , Chr         , 8 Khr       , Chr         , Aa^Fpa      , Mm^Xm       
Gs^Fp       , Gs^Fp       , Gs^Fp       , Rr          , Rr          , Rr          , Rr          , Rr          , Rr          , Rr          , Rr          , Rr          , Ch          , Ch          , Ch          , Rr          , Rr          , Ch          , Re          , Re          , Gs^Fp       , Re          , Gs^Fp       , Re          , Gs^Fp       , Gs^Fp       , Gs^Fp       , Re          , Re          , Gg^Fet      , Gg          , Gs^Fp       , Re          , Gg          , Re          , Gg          , Re          , Hh          , Re          , Re          , Re          , Re          , Gg          , Re          , Mm^Xm       , Gg          , Mm^Xm       , Gg^Efm         , Gg          , Re          , Ql^Bs\      , Ql          , Ql^Bs/      , Re          , Re          , Re          , Re          , Chr         , Chr         , Chr         , Aa^Fpa      , Mm^Xm       
Gg          , Gs^Fp       , Mm^Xm       , Gg          , Rr          , Rr          , Rr          , Rr          , Rr          , Rr          , Rr          , Rr          , Ch          , Kh          , Ch          , Rr          , Rr          , Ch          , Gg          , Gs^Fp       , Gs^Fp       , Gs^Fp       , Gs^Fp       , Gs^Fp       , Gs^Fp       , Gs^Fp       , Gs^Fp       , Gs^Fp       , Gg          , Re          , Re          , Re          , Re          , Re          , Gs^Fp       , Re          , Gs^Fp       , Re          , Gs^Fp       , Re          , Gs^Fp       , Gg          , Gg^Efm         , Re          , Gg          , Mm^Xm       , Mm^Xm       , Mm^Xm       , Mm^Xm       , Ql          , Ql          , Re          , Ql^Bs\      , Ql          , Re          , Gs^Fp       , Gs^Fp       , Chr         , Chr         , Chr         , Aa^Fpa      , Mm^Xm       
Mm^Xm       , Mm^Xm       , Mm^Xm       , Mm          , Mm^Xm       , Mm^Xm       , Rr          , Rr          , Rr          , Rr          , Rr          , Rr          , Rr          , Ch          , Rr          , Rr          , Rr          , Ch          , Gg          , Gs^Fp       , Gs^Fp       , Gs^Fp       , Gs^Fp       , Gs^Fp       , Gs^Fp       , Gs^Fp       , Gs^Fp       , Gs^Fp       , Gg          , Gg          , Gg          , Gg          , Gs^Fp       , Re          , Re          , Gs^Fp       , Gs^Fp       , Gs^Fp       , Gs^Fp       , Gs^Fp       , Gs^Fp       , Gg          , Gg          , Re          , Gg^Efm         , Gg          , Mm^Xm       , Mm^Xm       , Mm^Xm       , Ql          , Ql          , Ql          , Ql          , Re          , Gs^Fp       , Gs^Fp       , Aa^Fpa      , Aa^Fpa      , Aa^Fpa      , Aa^Fpa      , Gs^Fp       , Gs^Fp       
Mm^Xm       , Mm^Xm       , Mm^Xm       , Mm^Xm       , Mm^Xm       , Rr          , Rr          , Rr          , Ch          , Rr          , Rr          , Rr          , Rr          , Rr          , Rr          , Rr          , Ch          , Ch          , Gg          , Gg          , Gg          , Gs^Fp       , Gs^Fp       , Gg^Ve       , Gs^Fp       , Gs^Fp       , Gg          , Chr         , Chr         , Chr         , Gg          , Gg          , Gs^Fp       , Gs^Fp       , Gs^Fp       , Re          , Re          , Gs^Fp       , Gs^Fp       , Gs^Fp       , Gg          , Gg^Efm         , Gg          , Re          , Gg          , Gs^Fp       , Mm^Xm       , Mm^Xm       , Ql          , Ql          , Mm^Xm       , Ql          , Re          , Gs^Fp       , Gs^Fp       , Aa^Vha      , Aa^Fpa      , Aa^Fpa      , Aa^Fpa      , Aa^Fpa      , Mm^Xm       , Mm^Xm       
Mm^Xm       , Mm^Xm       , Mm          , Mm          , Rr          , Rr          , Rr          , Ch          , Kh          , Ch          , Rr          , Rr          , Rr          , Rr          , Rr          , Rr          , Rr          , Qxu         , Qxu         , Gg          , Gg          , Gs^Fp       , Gs^Fp       , Gs^Fp       , Gs^Fp       , Gg          , Gg          , Chr         , 3 Khr       , Chr         , Gg          , Gs^Fp       , Gs^Fp       , Gs^Fp       , Gs^Fp       , Gs^Fp       , Gs^Fp       , Re          , Re          , Gg          , Gg^Efm         , Gg          , Re          , Re          , Gs^Fp       , Gs^Fp       , Gs^Fp       , Mm^Xm       , Mm^Xm       , Ql          , Mm^Xm       , Mm^Xm       , Re          , Gs^Fp       , Aa          , Aa^Fpa      , Aa          , Aa^Fpa      , Aa          , Aa^Fpa      , Mm^Xm       , Mm^Xm       
Mm          , Mm          , Mm          , Mm          , Rr          , Rr          , Rr          , Ch          , Ch          , Ch          , Rr          , Rr          , Rr          , Rr          , Rr          , Rr          , Rr          , Rr          , Rr          , Qxu         , Qxu         , Gg          , Gg          , Gs^Fp       , Gg          , Gg          , Gg          , Chr         , Chr         , Chr         , Gg          , Gs^Fp       , Gs^Fp       , Gs^Fp       , Gs^Fp       , Gs^Fp       , Gg          , Gg          , Gg          , Re          , Re          , Gg^Efm         , Re          , Gs^Fp       , Gs^Fp       , Gg^Vh       , Gs^Fp       , Mm^Xm       , Mm^Xm       , Mm^Xm       , Mm^Xm       , Ha          , Aa          , Re          , Re          , Aa^Fpa      , Aa          , Aa          , Aa          , Aa          , Aa          , Mm^Xm       
Mm          , Mm^Xm       , Mm^Xm       , Ch          , Ch          , Rr          , Rr          , Rr          , Rr          , Rr          , Ch          , Rr          , Ch          , Ch          , Qxu         , Rr          , Rr          , Rr          , Rr          , Rr          , Rr          , Qxu         , Qxu         , Gg          , Gg          , Gs^Fp       , Gg          , Chr         , Gg          , Chr         , Gg          , Gs^Fp       , Gs^Fp       , Gg^Ve       , Gs^Fp       , Gs^Fp       , Gs^Fp       , Gg          , Gg          , Gg          , Gg          , Re          , Re          , Gs^Fp       , Gs^Fp       , Gs^Fp       , Mm^Xm       , Mm          , Mm^Xm       , Mm^Xm       , Mm^Xm       , Mm^Xm       , Aa          , Aa          , Aa          , Re          , Aa          , Aa          , Aa^Fpa      , Aa^Fpa      , Aa^Fpa      , Mm^Xm       
Mm^Xm       , Mm^Xm       , Mm^Xm       , Gg          , Gg          , Ch          , Ch          , Ch          , Ch          , Ch          , Gg          , Ch          , Gg          , Gg^Efm         , Gg          , Qxu         , Qxu         , Rr          , Rr          , Rr          , Rr          , Rr          , Rr          , Qxu         , Qxu         , Gg          , Gg          , Gg          , Gg          , Gg          , Gg          , Gg          , Gg          , Gs^Fp       , Gs^Fp       , Gs^Fp       , Gs^Fp       , Gg          , Gg          , Gg^Vh       , Gg          , Re          , Re          , Gs^Fp       , Gs^Fp       , Gs^Fp       , Mm^Xm       , Mm^Xm       , Mm^Xm       , Mm^Xm       , Mm^Xm       , Mm^Xm       , Aa^Fpa      , Aa          , Aa          , Re          , Aa          , Aa^Fpa      , Aa^Fpa      , Aa^Fpa      , Gs^Fp       , Mm^Xm       
Mm^Xm       , Mm^Xm       , Mm^Xm       , Mm^Xm       , Gg          , Gg          , Gs          , Re          , Gg          , Gg          , Gg          , Gg          , Gg          , Gg          , Gg          , Gg          , Gg          , Qxu         , Qxu         , Rr          , Rr          , Rr          , Rr          , Rr          , Rr          , Qxu         , Qxu         , Gg          , Gg          , Gg          , Gg          , Gg          , Gs^Fp       , Gs^Fp       , Gs^Fp       , Gs^Fp       , Gs^Fp       , Gg          , Cud         , Gg          , Cud         , Cud         , Re          , Gs^Fp       , Gs^Fp       , Gs^Fp       , Mm^Xm       , Mm^Xm       , Mm^Xm       , Mm^Xm       , Aa^Fpa      , Aa^Fpa      , Aa^Fpa      , Aa^Fpa      , Aa          , Re          , Aa          , Aa^Fpa      , Aa^Fpa      , Aa^Vea      , Mm^Xm       , Mm^Xm       
Mm^Xm       , Mm^Xm       , Gg^Efm         , Gg^Efm         , Gs          , Gs          , Gs          , Re          , Gg^Fet      , Gg          , Gg          , Hh          , Hh          , Hh          , Hh          , Gg^Fet      , Gg          , Gg          , Mm^Xm       , Qxu         , Qxu         , Rr          , Rr          , Rr          , Rr          , Rr          , Rr          , Qxu         , Qxu         , Gg          , Gg          , Gs^Fp       , Gs^Fp       , Gs^Fp       , Gs^Fp       , Gs^Fp       , Gg          , Gg          , Cud         , Cud         , 5 Kud       , Cud         , Re          , Gs^Fp       , Gs^Fp       , Mm^Xm       , Mm^Xm       , Mm^Xm       , Mm^Xm       , Aa^Fpa      , Aa^Fpa      , Aa^Fpa      , Aa^Fpa      , Aa^Fpa      , Aa          , Re          , Re          , Aa          , Aa^Fpa      , Aa^Fpa      , Mm^Xm       , Mm^Xm       
Mm^Xm       , Mm^Xm       , Gg          , Gg          , Gg          , Gs          , Re          , Re          , Gg          , Gg^Fet      , Hh          , Hh^Vhh      , Hh          , Hh          , Hh          , Gg          , Mm^Xm       , Mm^Xm       , Mm          , Mm^Xm       , Mm^Xm       , Qxu         , Qxu         , Rr          , Rr          , Rr          , Rr          , Rr          , Rr          , Qxu         , Qxu         , Gs^Fp       , Gs^Fp       , Gs^Fp       , Gs^Fp       , Gg          , Qxu         , Qxu         , Qxu         , Cud         , Re          , Re          , Gs^Fp       , Gs^Fp       , Mm^Xm       , Mm^Xm       , Mm^Xm       , Mm^Xm       , Re          , Aa^Fpa      , Aa^Fpa      , Aa^Fpa      , Aa^Fpa      , Aa^Fpa      , Aa          , Aa          , Re          , Aa^Fpa      , Aa^Fpa      , Aa^Fpa      , Mm^Xm       , Mm^Xm       
Mm^Xm       , Mm^Xm       , Gg          , Gg          , Gg^Fet      , Gs          , Re          , Gg          , Gs          , Gg^Efm         , Gg          , Hh          , Hh          , Hh          , Mm^Xm       , Mm^Xm       , Mm^Xm       , Mm          , Mm          , Mm^Vhh      , Mm          , Mm          , Mm          , Qxu         , Qxu         , Rr          , Rr          , Rr          , Rr          , Rr          , Rr          , Qxu         , Qxu         , Gs^Fp       , Qxu         , Qxu         , Rr          , Rr          , Rr          , Qxu^Bs/     , Qxu         , Gs^Fp       , Mm^Xm       , Mm^Xm       , Mm^Xm       , Mm^Xm       , Mm^Xm       , Mm^Xm       , Ai          , Re          , Re          , Aa^Fpa      , Re          , Aa^Fpa      , Re          , Re          , Re          , Aa^Fpa      , Aa^Fpa      , Aa^Fpa      , Mm^Xm       , Mm^Xm       
Mm^Xm       , Gg          , Gg          , Gg^Efm         , Gg          , Gg^Efm         , Re          , Gg          , Gs          , Gs          , Gg^Fet      , Gg          , Mm^Xm       , Mm^Xm       , Mm^Xm       , Mm^Xm       , Ww          , Mm          , Mm          , Mm          , Mm          , Mm          , Mm          , Mm          , Gg          , Qxu         , Qxu         , Rr          , Rr          , Rr          , Rr          , Rr          , Rr          , Qxu         , Rr          , Rr          , Rr          , Rr          , Rr          , Rr          , Qxu         , Qxu         , Aa^Fpa      , Mm^Xm       , Mm^Xm       , Mm^Xm       , Ai          , Ai          , Ai          , Ai          , Aa^Fpa      , Re          , Aa^Fpa      , Re          , Aa^Fpa      , Aa^Fpa      , Aa          , Re          , Ha          , Ha          , Mm^Xm       , Mm^Xm       
Mm^Xm       , Gg          , Gg          , Gg          , Gg          , Re          , Gg          , Gg          , Gg^Efm         , Gs          , Gg          , Mm^Xm       , Mm^Xm       , Mm^Xm       , Mm^Xm       , Mm^Xm       , Ww          , Ww          , Chw         , Chr         , Chr         , Mm          , Gg          , Mm          , Gs^Fp       , Gs^Fp       , Gs^Fp       , Qxu         , Qxu         , Rr          , Rr          , Rr          , Ch          , Rr          , Ch          , Rr          , Rr          , Rr          , Qxu         , Qxu         , Aa^Fpa      , Aa^Fpa      , Aa^Fpa      , Aa^Fpa      , Aa^Fpa      , Aa^Fpa      , Aa^Fpa      , Aa^Fpa      , Re          , Re          , Aa^Fpa      , Aa^Fpa      , Aa^Fpa      , Aa^Fpa      , Aa^Fpa      , Aa^Fpa      , Aa          , Re          , Ha          , Ha          , Mm^Xm       , Mm^Xm       
Mm^Xm       , Mm^Xm       , Gg          , Gg^Fet      , Re          , Re          , Gg          , Gg^Efm         , Gg          , Gg          , Gg          , Mm^Xm       , Mm^Xm       , Mm^Xm       , Ww          , Ww          , Ww          , Ww          , Chw         , Chr         , Chr         , Gg          , Gg^Efm         , Gg          , Gg          , Gs^Fp       , Gs^Fp       , Gs^Fp       , Qxu         , Qxu         , Rr          , Rr          , Ch          , Ch          , Ch          , Rr          , Rr          , Qxu         , Qxu         , Aa^Fpa      , Aa^Fpa      , Aa^Fpa      , Aa^Fpa      , Aa^Vea      , Aa^Fpa      , Aa^Fpa      , Aa^Fpa      , Aa^Fpa      , Re          , Aa^Fpa      , Aa^Fpa      , Aa^Fpa      , Aa^Vea      , Aa^Fpa      , Aa^Fpa      , Aa          , Aa          , Re          , Ha          , Aa^Fpa      , Mm^Xm       , Mm^Xm       
Mm^Xm       , Gg          , Gg          , Re          , Re          , Re          , Gg          , Gs^Fp       , Gs^Fp       , Gg          , Mm^Xm       , Mm^Xm       , Mm^Xm       , Mm^Xm       , Wo          , Wo          , Ww          , Chw         , Chw         , 6 Khr       , Rp          , Rp          , Gg          , Gg          , Gs^Fp       , Gs^Fp       , Qxu         , Qxu         , Rr          , Rr          , Rr          , Rr          , Rr          , Rr          , Rr          , Rr          , Rr          , Rr          , Rr          , Qxu         , Qxu         , Aa^Fpa      , Aa^Fpa      , Aa^Fpa      , Aa^Fpa      , Aa^Fpa      , Aa^Fpa      , Aa^Fpa      , Re          , Aa^Fpa      , Aa^Fpa      , Aa^Fpa      , Aa          , Aa^Fpa      , Aa          , Aa          , Re          , Re          , Ha          , Aa^Fpa      , Mm^Xm       , Mm^Xm       
Mm^Xm       , Mm^Xm       , Gg          , Re          , Gs^Fp       , Gs^Fp       , Gs^Fp       , Gs^Fp       , Aa^Fpa      , Gs^Fp       , Mm^Xm       , Mm^Xm       , Wo          , Wo          , Wo          , Ww          , Ww          , Chw         , Ww          , Rp          , Rp          , Gg          , Gg^Efm         , Gg          , Gg^Vh       , Qxu         , Qxu         , Rr          , Rr          , Rr          , Rr          , Rr          , Qxu         , Qxu         , Qxu         , Rr          , Rr          , Rr          , Rr          , Rr          , Rr          , Qxu         , Qxu         , Aa^Fpa      , Aa^Fpa      , Aa^Fpa      , Aa          , Aa^Fpa      , Re          , Aa^Fpa      , Aa^Fpa      , Aa^Fpa      , Aa          , Aa          , Chr         , Chr         , Chr         , Re          , Ha          , Aa^Fpa      , Mm^Xm       , Mm^Xm       
Mm^Xm       , Mm^Xm       , Gg^Efm         , Re          , Gg          , Gs^Fp       , Aa^Fpa      , Aa^Fpa      , Aa^Fpa      , Mm^Xm       , Mm^Xm       , Mm^Xm       , Wo          , Wo          , Wo          , Ww          , Ww          , Ww          , Gg^Efm         , Gg          , Rp          , Gs          , Gs          , Gg          , Gg^Efm         , Gg          , Rp          , Qxu^Bs/     , Qxu         , Rr          , Qxu         , Qxu         , Gs^Fp       , Gs^Fp       , Gs^Fp       , Qxu         , Qxu         , Rr          , Rr          , Rr          , Rr          , Rr          , Rr          , Qxu         , Qxu         , Aa          , Re          , Re          , Aa^Fpa      , Re          , Re          , Aa^Fpa      , Aa          , Chr         , Chr         , 9 Khr       , Chr         , Re          , Ha          , Aa^Fpa      , Mm^Xm       , Mm^Xm       
Mm^Xm       , Mm^Xm       , Gg          , Re          , Gg          , Gs^Fp       , Aa^Fpa      , Aa^Fpa      , Mm^Xm       , Mm^Xm       , Mm^Xm       , Wo          , Wo          , Wo          , Wo          , Ww          , Gg^Fet      , Gg          , Gs          , Gg          , Rp          , Gs          , Gg          , Gg          , Rp          , Rp          , Gs^Fp       , Gs^Fp       , Gs^Fp       , Qxu         , Gs^Fp       , Gs^Fp       , Gs^Fp       , Gs^Fp       , Gs^Fp       , Gs^Fp       , Gs^Fp       , Qxu         , Qxu         , Rr          , Rr          , Rr          , Rr          , Rr          , Rr          , Qxu         , Qxu         , Aa          , Aa          , Aa^Fpa      , Aa^Fpa      , Re          , Re          , Aa          , Chr         , Chr         , Xu          , Re          , Xu          , Xu          , Xu          , Mm^Xm       
Mm^Xm       , Mm^Xm       , Ha          , Re          , Re          , Gs^Fp       , Ha          , Aa^Fpa      , Mm^Xm       , Mm^Xm       , Mm^Xm       , Wo          , Wo          , Wo          , Ww          , Ww          , Gg^Vh       , Gs          , Gg^Efm         , Gg          , Rp          , Gs          , Rp          , Rp          , Hh          , Re          , Re          , Gs^Fp       , Gs^Fp       , Gs^Fp       , Gs^Fp       , Gs^Fp       , Gs^Fp       , Gs^Fp       , Gs^Fp       , Gs^Fp       , Gs^Fp       , Mm          , Mm          , Qxu         , Qxu         , Rr          , Rr          , Rr          , Rr          , Rr          , Rr          , Qxu         , Qxu         , Aa          , Aa          , Aa^Fpa      , Aa          , Re          , Xu          , Xu          , Ha          , Xu          , Ha          , Ha          , Gg^Efm         , Mm^Xm       
Mm^Xm       , Ha          , Aa^Fpa      , Gg          , Re          , Gg          , Ha          , Ha^Vhha     , Mm^Xm       , Mm^Xm       , Mm^Xm       , Wo          , Wo          , Wo          , Ww          , Ww          , Gg^Efm         , Gg          , Gg          , Gg^Fet      , Rp          , Rp          , Hh          , Hh          , Hh          , Re          , Re          , Gs^Fp       , Gs^Fp       , Gs^Fp       , Gs^Fp       , Gs^Fp       , Gs^Fp       , Gs^Fp       , Gs^Fp       , Gs^Fp       , Gs^Fp       , Mm          , Mm          , Mm          , Mm          , Qxu         , Qxu         , Rr          , Rr          , Rr          , Rr          , Rr          , Rr          , Qxu         , Qxu         , Aa          , Xu          , Xu          , Ha          , Ha          , Ha          , Re          , Aa^Fpa      , Aa^Fpa      , Mm          , Mm^Xm       
Mm^Xm       , Ha          , Ha          , Ha          , Re          , Re          , Ha          , Ha          , Gg          , Mm^Xm       , Mm^Xm       , Wo          , Wo          , Wo          , Ww          , Ww          , Gg          , Gg^Fet      , Rp          , Rp          , Hh          , Hh          , Hh          , Hh          , Hh          , Hh          , Hh          , Re          , Re          , Gs^Fp       , Re          , Gs^Fp       , Gs^Fp       , Gs^Fp       , Gs^Fp       , Gs^Fp       , Gs^Fp       , Gs^Fp       , Mm          , Mm          , Mm          , Mm          , Mm          , Qxu         , Qxu         , Rr          , Rr          , Rr          , Rr          , Rr          , Rr          , Qxu         , Qxu         , Ha          , Ha          , Ha          , Ch          , Re          , Gs^Fp       , Mm          , Mm^Xm       , Mm          
Mm^Xm       , Aa^Vea      , Gg          , Gg          , Re          , Re          , Ha          , Ha          , Mm^Xm       , Mm^Xm       , Mm^Xm       , Wo          , Wo          , Wo          , Ww          , Ww          , Gg          , Rp          , Hh          , Hh          , Mm          , Mm          , Mm          , Hh          , Hh          , Hh          , Hh          , Hh          , Hh          , Re          , Re          , Re          , Re          , Gs^Fp       , Gs^Fp       , Gs^Fp       , Mm          , Mm          , Mm          , Mm          , Mm          , Mm          , Mm          , Mm^Vhh      , Mm          , Qxu         , Qxu         , Rr          , Rr          , Rr          , Rr          , Rr          , Rr          , Qxu         , Ch          , Ch          , Rr          , Ch          , Mm^Xm       , Mm^Xm       , Mm          , Mm^Xm       
Mm^Xm       , Mm^Xm       , Mm          , Re          , Ha          , Ha          , Ai          , Mm^Xm       , Ai          , Mm^Xm       , Mm^Xm       , Mm^Xm       , Wo          , Ww          , Wwf         , Gg          , Rp          , Rp          , Hh          , Hh          , Mm          , Mm          , Mm          , Mm          , Mm          , Mm          , Hh          , Hh^Vhh      , Hh          , Hh          , Hh          , Hh          , Hh          , Re          , Gg          , Gg^Efm         , Gg          , Mm          , Mm          , Mm          , Mm          , Mm          , Chr         , Chr         , Chr         , Mm          , Mm          , Qxu         , Qxu         , Rr          , Rr          , Rr          , Rr          , Rr          , Rr          , Rr          , Mm^Xm       , Mm^Xm       , Mm^Xm       , Mm^Xm       , Gg          , Mm          
Mm^Xm       , Mm          , Mm          , Mm          , Mm          , Ha          , Wo          , Ai          , Wo          , Wo          , Mm^Xm       , Mm^Xm       , Wwf         , Wwf         , Wwf         , Rp          , Hh          , Hh          , Hh          , Hh          , Mm          , Mm          , Mm          , Mm          , Mm          , Hh          , Mm          , Hh          , Hh          , Hh          , Hh          , Hh          , Hh          , Re          , Re          , Gg^Efm         , Gg^Fet      , Mm          , Mm          , Mm          , Mm          , Mm          , Chr         , Chr         , 7 Khr       , Chr         , Xu          , Xu          , Ha          , Qxu         , Ch          , Rr          , Rr          , Rr          , Rr          , Rr          , Rr          , Rr          , Gg          , Gg          , Gs^Fp       , Gg          
Mm          , Mm          , Mm          , Mm          , Mm          , Wo          , Wo          , Wo          , Wwf         , Wwf         , Wwf         , Wwf         , Wwf         , Wwf         , Wwf         , Hh          , Hh          , Hh          , Hh          , Mm          , Mm          , Mm          , Mm          , Mm          , Mm          , Mm          , Mm          , Mm          , Mm          , Hh          , Hh          , Hh          , Hh          , Gg          , Gg          , Re          , Re          , Re          , Re          , Mm          , Mm          , Mm          , Mm          , Chr         , Chr         , Xu          , Ha          , Ha          , Ch          , Ch          , Rr          , Rr          , Mm^Xm       , Rr          , Rr          , Rr          , Rr          , Rr          , Rr          , Gg^Efm         , Gg^Fet      , Gg          
Mm          , Mm          , Chr         , Chr         , Chr         , Mm          , Mm          , Wo          , Wwf         , Wwf         , Ww          , Wwf         , Ww          , Wwf         , Wwf         , Hh          , Mm^Xm       , Hh          , Mm          , Mm          , Mm          , Mm          , Mm          , Mm          , Mm^Vhh      , Mm          , Mm          , Mm          , Mm          , Mm          , Hh          , Hh          , Mm          , Gg^Efm         , Gg^Efm         , Gg          , Mm          , Re          , Re          , Re          , Re          , Mm          , Re          , Chr         , Chr         , Xu          , Ha          , Ha          , Re          , Ch          , Mm^Xm       , Mm^Xm       , Mm^Xm       , Rr          , Gs^Fp       , Rr          , Rr          , Rr          , Rr          , Rr          , Rr          , Gg          
Mm          , Mm          , Chr         , Chr         , Chr         , Mm          , Mm          , Mm          , Mm          , Ww          , Ww          , Ww          , Ww          , Ww          , Ww          , Mm^Xm       , Mm^Xm       , Mm^Xm       , Mm^Xm       , Mm          , Mm          , Mm          , Mm          , Mm          , Mm          , Mm          , Mm          , Mm          , Mm          , Mm          , Mm          , Mm          , Mm          , Gg^Efm         , Gg          , Gg^Fet      , Mm          , Mm          , Mm          , Mm          , Mm          , Re          , Mm          , Re          , Re          , Xu          , Re          , Re          , Ha          , Aa^Fpa      , Mm          , Mm^Xm       , Mm^Xm       , Gs^Fp       , Gs^Fp       , Gg^Efm         , Gg^Efm         , Rr          , Rr          , Rr          , Rr          , Rr          
Mm          , Mm          , Mm          , 4 Khr       , Mm          , Mm          , Mm          , Mm^Vhh      , Mm^Xm       , Mm^Xm       , Mm^Xm       , Mm^Xm       , Ww          , Ww          , Ww          , Mm^Xm       , Mm^Xm       , Mm^Xm       , Mm^Xm       , Mm          , Mm          , Mm          , Mm          , Mm^Xm       , Mm^Xm       , Mm          , Mm^Xm       , Mm          , Mm^Xm       , Mm          , Mm^Xm       , Mm          , Mm^Xm       , Mm          , Mm^Xm       , Mm          , Mm          , Mm          , Mm          , Mm          , Mm^Xm       , Mm          , Mm          , Mm          , Mm          , Xu          , Ha          , Ha          , Aa^Fpa      , Aa^Fpa      , Mm^Xm       , Mm^Xm       , Mm          , Gs^Fp       , Gg^Efm         , Gg^Efm         , Gg          , Gg          , Gg          , Rr          , Rr          , Rr          
Mm          , Mm          , Mm          , Mm          , Mm          , Mm          , Mm          , Mm          , Mm^Xm       , Mm^Xm       , Mm^Xm       , Ww          , Ww          , Ww          , Ww          , Mm^Xm       , Mm^Xm       , Mm^Xm       , Mm^Xm       , Mm^Xm       , Mm^Xm       , Mm^Xm       , Mm^Xm       , Mm^Xm       , Mm^Xm       , Mm^Xm       , Mm^Xm       , Mm^Xm       , Mm^Xm       , Mm^Xm       , Mm^Xm       , Mm^Xm       , Mm^Xm       , Mm^Xm       , Mm          , Mm^Xm       , Mm^Xm       , Mm^Xm       , Mm^Xm       , Mm^Xm       , Mm^Xm       , Mm^Xm       , Mm^Xm       , Mm^Xm       , Mm^Xm       , Mm^Xm       , Mm^Xm       , Mm^Xm       , Mm^Xm       , Mm^Xm       , Mm^Xm       , Mm^Xm       , Mm^Xm       , Gg          , Gg          , Gg^Fet      , Gg          , Hh          , Gg          , Gs^Fp       , Gg          , Rr          
